#################
#.#.......#.....#
#.#.###.#####.###
#.#.#.....#.#...#
#.###.#.###.#.#.#
#.#.#.#.#.#...#.#
#.#.###.#.#.###.#
#.....#.#.....#.#
#.#####.#.#.#.###
#...#.....#.#...#
#.#####.#########
#.#.#...........#
#.#.#########.###
#.....#.....#...#
#.#.#.#####.#.###
#.#.#.#.....#...#
#.###.###.#####.#
#...#...........#
#################
